F 156,74,0
C 148,148,255

NO ./asset/tile_mario_0.xpm
SO ./asset/tile_mario_1.xpm
WE ./asset/tile_mario_2.xpm
EA ./asset/tile_mario_3.xpm

    1111111   1111111111111
   1100011    1100000000001
  1100011     100111100S001
 1100011      1111  1000001
1100011            11000011
10000111111111   111000111
10000000000001 111000111
1111111110000111000011 1111
        1000011000001111001
        1000000000000000001
        1111111111111111111
