NO ./asset/tile_n.xpm
SO ./asset/tile_s.xpm
WE ./asset/tile_w.xpm
EA ./asset/tile_e.xpm

1111    1111111111111111111111111
1001    1000100000110000000000001
1001    1011000001110000000000001
1001    100000E000000000000000001
111111111011000001110000000000001
100000000011100001110111111111111
11110111111111011100000010001
11110111111111011101010010001
11000000110101011100000010001
10000000000000001100000010001
10000000000000001101010010001
1100000111010101111101111000111
11110111 1110101 101111010001
11111111 1111111 111111111111

F 20,35,125
C 123,123,123
